1111111111111111
1222222222222221
1222222222222221
1222222222222221
1222222222222221
1222222222222221
1222222222222221
1222222222222221
1212121212121211
1222222222222221
1111111111111111