52525252525252020252525252525252
52525252195253020252525252525252
52525253020202020252525252525252
52525302020202020252525252525252
52530202020202020251525252525252
02020202020202020202020202020202
37380202020202020202020202023737
52520202020202020202020202025252
52520202020202020202020202025252
52523838383838383838383838385252
52525252525252525252525252525252