53,53,53,53,53,53,53,3,3,53,53,53,53,53,53,53,
53,53,53,53,20,53,54,3,3,53,53,53,53,53,53,53,
53,53,53,54,3,3,3,3,3,53,53,53,53,53,53,53,
53,53,54,3,3,3,3,3,3,53,53,53,53,53,53,53,
53,54,3,3,3,3,3,3,3,52,53,53,53,53,53,53,
3,3,3,3,3,3,3,3,3,3,3,3,3,3,3,3,
53,39,3,3,3,3,3,3,3,3,3,3,3,3,53,53,
53,53,3,3,3,3,3,3,3,3,3,3,3,3,53,53,
53,53,3,3,3,3,3,3,3,3,3,3,3,3,53,53,
53,53,38,38,38,38,38,38,38,38,38,38,38,38,53,53,
53,53,53,53,53,53,53,53,53,53,53,53,53,53,53,53,

