53,53,23,3,23,3,23,3,3,23,3,23,3,23,3,23,
53,53,23,3,23,3,23,3,3,23,3,23,3,23,3,23,
53,53,3,3,3,3,3,3,3,3,3,3,3,3,3,3,
53,54,3,3,3,3,23,3,3,23,3,23,3,23,3,3,
54,3,23,3,23,3,3,3,3,3,3,3,3,3,3,3,
3,3,3,3,3,3,23,3,3,23,3,23,3,23,3,3,
39,3,23,3,23,3,3,3,3,3,3,3,3,3,3,3,
53,39,3,3,3,3,23,3,3,23,3,23,3,23,3,3,
53,53,3,3,3,3,3,3,3,3,3,3,3,3,3,3,
53,53,23,23,23,23,23,23,23,23,23,23,23,23,23,23,
53,53,23,23,23,23,23,23,23,23,23,23,23,23,23,23,

