53,53,23,17,23,17,23,17,17,23,17,23,17,23,17,23,
53,53,23,3,23,3,23,3,3,23,3,23,3,23,3,23,
53,53,3,3,3,3,3,3,3,3,3,3,3,3,3,8,
53,54,3,3,3,3,23,3,3,23,3,23,3,23,3,8,
54,3,23,3,23,3,3,3,3,3,3,3,3,3,3,8,
3,3,3,3,3,3,23,3,3,23,3,23,3,23,3,8,
39,3,23,3,23,3,3,3,3,3,3,3,3,3,3,8,
53,39,3,3,3,3,23,3,3,23,3,23,3,23,3,8,
53,53,3,3,3,3,3,3,3,3,3,3,3,3,3,8,
53,53,23,23,23,23,23,23,23,23,23,23,23,23,23,23,
53,53,23,23,23,23,23,23,23,23,23,23,23,23,23,23,

