53,53,53,53,53,53,53,53,53,53,53,53,53,53,53,53,
53,53,53,53,53,53,53,53,53,53,53,53,53,53,53,53,
53,3,3,3,3,3,3,3,3,3,3,3,3,3,52,53,
53,3,3,3,3,3,3,3,3,8,3,3,3,3,3,53,
53,3,3,3,3,3,3,3,3,3,3,8,3,3,3,52,
53,3,3,8,3,3,8,3,3,8,3,3,3,3,3,3,
53,3,3,3,3,3,3,3,3,3,3,8,3,3,3,37,
53,3,3,3,3,3,3,3,3,8,3,3,3,3,37,53,
53,3,3,3,3,3,3,3,3,3,3,3,3,3,53,53,
53,38,38,38,38,38,38,38,38,38,38,38,38,38,53,53,
53,53,53,53,53,53,53,53,53,53,53,53,53,53,53,53,

