53,53,53,53,53,53,53,53,53,53,53,53,53,53,53,53,
53,53,53,53,53,53,53,53,53,53,53,53,53,53,53,53,
53,54,3,3,3,3,3,3,3,52,54,3,3,3,52,53,
54,3,3,8,3,8,3,3,3,3,3,3,8,3,3,52,
2,3,3,3,3,3,3,3,3,3,3,3,3,3,3,2,
2,3,3,8,3,8,3,3,3,3,3,3,8,3,3,2,
2,3,3,3,3,3,3,3,3,3,3,3,3,3,3,2,
39,3,3,8,3,8,3,3,3,3,3,3,8,3,3,37,
53,39,3,3,3,3,3,3,3,37,39,3,3,3,37,53,
53,53,38,38,38,38,38,3,3,53,53,38,38,38,53,53,
53,53,53,53,53,53,53,3,3,53,53,53,53,53,53,53,

